18
20
15
0 0 0 0 0 0 0 0 0 0 0 0 0 0 0 0 0 0 0 0 
0 0 0 0 0 0 0 0 0 0 1 1 1 1 1 1 1 0 0 0 
0 0 0 0 0 0 0 0 0 0 1 2 2 4 4 4 1 0 0 0 
0 0 0 0 0 0 1 1 1 1 1 2 2 4 4 4 1 0 0 0 
0 0 0 0 0 0 1 2 2 2 2 2 2 4 2 4 1 0 0 0 
0 0 0 0 0 0 1 2 2 1 1 2 2 4 4 4 1 0 0 0 
0 0 0 0 0 0 1 1 2 1 1 2 2 4 4 4 1 0 0 0 
0 0 0 0 0 1 1 1 2 1 1 1 1 1 1 1 1 0 0 0 
0 0 0 0 0 1 2 3 3 3 2 1 1 0 0 0 0 0 0 0 
0 1 1 1 1 1 2 2 3 2 3 2 1 1 1 1 1 0 0 0 
1 1 2 2 2 1 3 2 3 2 2 2 1 2 2 2 1 0 0 0 
1 6 2 3 2 2 3 2 2 2 2 3 2 2 3 2 1 0 0 0 
1 1 1 1 1 1 2 3 3 2 3 2 1 1 1 1 1 0 0 0 
0 0 0 0 0 1 2 2 2 2 2 2 1 0 0 0 0 0 0 0 
0 0 0 0 0 1 1 1 1 1 1 1 1 0 0 0 0 0 0 0 
0 0 0 0 0 0 0 0 0 0 0 0 0 0 0 0 0 0 0 0 
0 0 0 0 0 0 0 0 0 0 0 0 0 0 0 0 0 0 0 0 
0 0 0 0 0 0 0 0 0 0 0 0 0 0 0 0 0 0 0 0 
